##############################
#.............##.............#
#.###.####.##.##.##.####.###.#
#.###.####.##.##.##.####.###.#
#..............@.............#
#.###.#.##.########.##.#.###.#
#.###.#.......##.......#.###.#
#.###.#####...##...#####.###.#
#.###.#...............##.###.#
#.###.####.##.##.##.####.###.#
#.###.####.##.##.##.####.###.#
#.###.####.##.##.##.####.###.#
#............................#
#.###.#....#######....#.####.#
#.##....#            #....##.#
#.##..###            ###..##.#
#.##..###            ###..##.#
#.##....##############....##.#
#.###.####.##.##.##.####.###.#
#.###.####.##.##.##.####.###.#
#.###.####.##.##.##.####.###.#
#.......#..#......#..#.......#
#####....................#####
#####.#####...##...#####.#####
#.###.#.......##.......#.###.#
#.###.#.##.########.##.#.###.#
#............................#
#.###.####.##.##.##.####.###.#
#.............##.............#
##############################
