##############################
#...##...##...###...##...##..#
#............................#
#.#..#..####..##..####..#..#.#
#........##..####..##........#
#####.........##..........####
#####...####.......####...####
#.....###.............###....#
#.........###.....###........#
#....#......#....#.......#...#
#....#......#....#.......#...#
#.......##...........##......#
####......................####
#.......#####....#####.......#
#.....###            ###.....#
##....###            ###.....#
#.......##############.......#
#...##...##...###...##...##..#
#............................#
#.#..#..####..##..####..#..#.#
#........##..####..##........#
#####.........##..........####
#####...####.......####...####
#.....###.............###....#
#.........###.....###........#
#....#......#....#.......#...#
#....#......#....#.......#...#
#.......##...........##......#
#####.....................####
##############################
