##############################
##############################
#.............##.....%.......#
#.###.####.##.##.##.####.###.#
#.###.####.##.##.##.####.###.#
#............................#
#.###.#.##.########.##.#.###.#
#.###.#.......##.......#.###.#
#.###.#####...##...#####.###.#
#.###.#...$...........##.###.#
#.###.####.##.##.##.####.###.#
#.###.####.##.##.##.####.###.#
#.###.####.##.##.##.####.###.#
#............................#
#.###.#....#######....#..###.#
#.##....#            #....##.#
#.##..###            ###..##.#
#.##..###            ###..##.#
#.##....##############....##.#
#.###.####.##.##.##.####.###.#
#.###.####.##.##.##.####.###.#
#@......#..#......#..#.......#
#####....................#####
#####.#####...##...#####.#####
#.###.#.......##.......#.###.#
#.###.#.##.########.##.#.###.#
#............................#
#.###.####.##.##.##.####.###.#
#.............##.............#
##############################
