##############################
#.............##.............#
#.###.####.##.##.##.####.###.#
#.###.####.##.##.##.####.###.#
#............................#
#.###.#....########....#.###.#
#.###.#.......##.......#.###.#
#####.#####...##...#####.#####
#####.#...............#.######
#.###.####.##.##.##.####.###.#
#.###.####.##.##.##.####.###.#
#.###.####.##.##.##.####.###.#
#............................#
#.###.#....#######....#.####.#
#.......#   #   #    #.......#
#.....###            ###.....#
##....###            ###.....#
#.......##############.......#
#.###.####.##.##.##.####.###.#
#.###.####.##.##.##.####.###.#
#.###.####.##.##.##.####.###.#
#......##..#......#..##......#
#####.#...............#.######
#####.#####...##...#####.#####
#.###.#.......##.......#.###.#
#.###.#.##.########.##.#.###.#
#............................#
#.###.####.##.##.##.####.###.#
#.###.####.##.##.##.####.###.#
#.............##.............#
##############################
