##############################
#   ##   ##   ###   ##   ##  #
#                            #
# #  #  ####  ##  ####  #  # #
#        ##  ####  ##        #
#####         ##          ####
#####   ####       ####   ####
#     ###             ###    #
#         ###     ###        #
#    #      #    #       #   #
#    #      #    #       #   #
#       ##           ##      #
####                      ####
#       #####    #####       #
#     ###            ###     #
##    ###            ###     #
#       ##############       #
#   ##   ##   ###   ##   ##  #
#                            #
# #  #  ####  ##  ####  #  # #
#        ##  ####  ##        #
#####         ##          ####
#####   ####       ####   ####
#     ###             ###    #
#         ###     ###        #
#    #      #    #       #   #
#    #      #    #       #   #
#       ##           ##      #
#####                     ####
##############################
