##############################
##############################
#.............##.....%.......#
#.###.####.##.##.##.####.###.#
#.###.####.##.##.##.####.###.#
#.......................%....#
#.###.#.##.########.##.#.###.#
#.###.#.$.....##.......#.###.#
#.###.#####...##...#####.###.#
#.###.#...............##.###.#
#.###.####.##.##.##.####.###.#
#.###.####.##.##.##.####.###.#
#.###.####.##.##.##.####.###.#
#....................%.......#
#.###.#....#######....#..###.#
#.##....#            #....##.#
#.##..###            ###..##.#
#.##..###            ###..##.#
#.##....##############....##.#
#.###.####.##.##.##.####.###.#
#.###.####.##.##.##.####.###.#
#@......#..#......#..#.......#
#####..@.................#####
#####.#####...##...#####.#####
#.###.#.......##.......#.###.#
#.###.#.##.########.##.#.###.#
#............................#
#.###.####.##.##.##.####.###.#
#....%........##.............#
##############################
