##############################
#          #   # #     #######
# # ####### # # # ### ########
# # #   #     # #       ######
# # # # ############# # ######
# #   # #             # ######
# ####### # ### ####### ######
#   #     # # # # #     ######
# # # ##### # # # ############
# # # # # # # # #       ######
# ### # # # # ### ##### ######
# #     # #     #     # ######
# ### ### # ##### ### # ######
#       #         #   # ######
#          #   # #     #######
# # ####### # # # ### ########
# # #   #     # #       ######
# # # # ############# # ######
# #   # #             # ######
# ####### # ### ####### ######
#   #     # # # # #     ######
# # # ##### # # # ############
# # # # # # # # #       ######
# ### # # # # ### ##### ######
# #     # #     #     # ######
# ### ### # ##### ### # ######
#       #         #   # ######
##############################
##############################
##############################
