##############################
##############################
#....@........##.....%.......#
#.###.####.##.##.##.####.###.#
#.###.####.##.##.##.####.###.#
#..........$............%....#
#.###.#.##.########.##.#.###.#
#.###.#.@.....##.......#.###.#
#.###.#####...##...#####.###.#
#.###.#...............##.###.#
#.###.####.##.##.##.####.###.#
#.###.####.##.##.##.####.###.#
#.###.####.##.##.##.####.###.#
#....................%.......#
#.###.#....#######....#..###.#
#.##....#            #....##.#
#.##..###            ###..##.#
#.##..###            ###..##.#
#.##....##############....##.#
#.###.####.##.##.##.####.###.#
#.###.####.##.##.##.####.###.#
#%......#..#......#..#.......#
#####..%.........$.......#####
#####.#####...##...#####.#####
#.###.#.......##.......#.###.#
#.###.#.##.########.##.#.###.#
#............................#
#.###.####.##.##.##.####.###.#
#....%........##.............#
##############################
